111111111
1E0000001
100000001
100000001
10C001111
100001001
1000010P1
111111111
