111111111111
1000000010E1
1000C0001001
100000001111
100000000001
100000000001
1P0000000001
111111111111
