111111111111
100011100001
10001C10E001
1C0011100001
100000000001
100P00C00001
100000000001
111111111111
