11111111111111
10000000000001
10010000001001
100C000000C001
10001000010001
10000111100001
1P0000000000E1
11111111111111
