111111111111
1P00000000C1
111110000001
1E0010000001
100010000001
100010001101
10111001C101
100000100101
1C0001000001
111111111111
