11111111111111111111111111111111111111111111111111111111111111111111111111111111111111111111111111111111111111111111111111111
11100000000000010000000000000000000000000000000000000000000000000000000000000000000000000000000000000000000000000000000000001
10000000000100000000000000000011100000000000000000000000000000000000000000000000000000000000000000000000000000000000000000001
10000000000010000000001111111110110000000000000000000000000000000000000000000000000000000000000000000000000000000000000000001
10000001100001000000001000C00000011000000000000000000000000000000000000000000000000000000000000000000000000000000000000000001
10000100000001001000001000000000111111100000000000000000000000000000000000000000000000000000000000000000000000000000000000001
10000000000000000001111000000000100111110000000000000000000000000000000000000000000000000000000000000000000000000000000000001
100001000000C0001001000000000000100111110000000000000000000000000000000000000000000000000000000000000000000000000000000000001
1000000000000010001100000P000000100111110000000000000000000000000000000000000000000000000000000000000000000000000000000000001
10000100000000100010000000000000110110000000000000000000000000000000000000000000000000000000000000000000000000000000000000001
10000000000100001010100E00000000011100000000000000000000000000000000000000000000000000000000000000000000000000000000000000001
10000000000000100011000000000000011000000000000000000000000000000000000000000000000000000000000000000000000000000000000000001
1000000000C000110000000000000000000000000000000000000000000000000000000000000000000000000000000000000000000000000000000000001
10000000000000100000000000000000000000000000000000000000000000000000000000000000000000000000000000000000000000000000000000001
10000000000000000000000010010000000000000000000000000000000000000000000000000000000000000000000000000000000000000000000000001
10000000000000000000000000000000000000000000000000000000000000000000000000000000000000000000000000000000000000000000000000001
10000000000000000000000000000000000000000000000000000000000000000000000000000000000000000000000000000000000000000000000000001
10000000000000000000000000000000000000000000000000000000000000000000000000000000000000000000000000000000000000000000000000001
10000000000000000000000000000000000000000000000000000000000000000000000000000000000000000000000000000000000000000000000000001
10000000000000000000000000000000000000000000000000000000000000000000000000000000000000000000000000000000000000000000000000001
10000000000000000000000000000000000000000000000000000000000000000000000000000000000000000000000000000000000000000000000000001
10000000000000000000000000000000000000000000000000000000000000000000000000000000000000000000000000000000000000000000000000001
10000000000000000000000000000000000000000000000000000000000000000000000000000000000000000000000000000000000000000000000000001
10000000000000000000000000000000000000000000000000000000000000000000000000000000000000000000000000000000000000000000000000001
10000000000000000000000000000000000000000000000000000000000000000000000000000000000000000000000000000000000000000000000000001
10000000000000000000000000000000000000000000000000000000000000000000000000000000000000000000000000000000000000000000000000001
10000000000000000000000000000000000000000000000000000000000000000000000000000000000000000000000000000000000000000000000000001
10000000000000000000000000000000000000000000000000000000000000000000000000000000000000000000000000000000000000000000000000001
10000000000000000000000000000000000000000000000000000000000000000000000000000000000000000000000000000000000000000000000000001
10000000000000000000000000000000000000000000000000000000000000000000000000000000000000000000000000000000000000000000000000001
10000000000000000000000000000000000000000000000000000000000000000000000000000000000000000000000000000000000000000000000000001
10000000000000000000000000000000000000000000000000000000000000000000000000000000000000000000000000000000000000000000000000001
10000000000000000000000000000000000000000000000000000000000000000000000000000000000000000000000000000000000000000000000000001
10000000000000000000000000000000000000000000000000000000000000000000000000000000000000000000000000000000000000000000000000001
10000000000000000000000000000000000000000000000000000000000000000000000000000000000000000000000000000000000000000000000000001
10000000000000000000000000000000000000000000000000000000000000000000000000000000000000000000000000000000000000000000000000001
10000000000000000000000000000000000000000000000000000000000000000000000000000000000000000000000000000000000000000000000000001
10000000000000000000000000000000000000000000000000000000000000000000000000000000000000000000000000000000000000000000000000001
10000000000000000000000000000000000000000000000000000000000000000000000000000000000000000000000000000000000000000000000000001
10000000000000000000000000000000000000000000000000000000000000000000000000000000000000000000000000000000000000000000000000001
10000000000000000000000000000000000000000000000000000000000000000000000000000000000000000000000000000000000000000000000000001
10000000000000000000000000000000000000000000000000000000000000000000000000000000000000000000000000000000000000000000000000001
10000000000000000000000000000000000000000000000000000000000000000000000000000000000000000000000000000000000000000000000000001
10000000000000000000000000000000000000000000000000000000000000000000000000000000000000000000000000000000000000000000000000001
10000000000000000000000000000000000000000000000000000000000000000000000000000000000000000000000000000000000000000000000000001
10000000000000000000000000000000000000000000000000000000000000000000000000000000000000000000000000000000000000000000000000001
10000000000000000000000000000000000000000000000000000000000000000000000000000000000000000000000000000000000000000000000000001
10000000000000000000000000000000000000000000000000000000000000000000000000000000000000000000000000000000000000000000000000001
10000000000000000000000000000000000000000000000000000000000000000000000000000000000000000000000000000000000000000000000000001
10000000000000000000000000000000000000000000000000000000000000000000000000000000000000000000000000000000000000000000000000001
10000000000000000000000000000000000000000000000000000000000000000000000000000000000000000000000000000000000000000000000000001
10000000000000000000000000000000000000000000000000000000000000000000000000000000000000000000000000000000000000000000000000001
10000000000000000000000000000000000000000000000000000000000000000000000000000000000000000000000000000000000000000000000000001
10000000000000000000000000000000000000000000000000000000000000000000000000000000000000000000000000000000000000000000000000001
10000000000000000000000000000000000000000000000000000000000000000000000000000000000000000000000000000000000000000000000000001
10000000000000000000000000000000000000000000000000000000000000000000000000000000000000000000000000000000000000000000000000001
10000000000000000000000000000000000000000000000000000000000000000000000000000000000000000000000000000000000000000000000000001
10000000000000000000000000000000000000000000000000000000000000000000000000000000000000000000000000000000000000000000000000001
10000000000000000000000000000000000000000000000000000000000000000000000000000000000000000000000000000000000000000000000000001
10000000000000000000000000000000000000000000000000000000000000000000000000000000000000000000000000000000000000000000000000001
10000000000000000000000000000000000000000000000000000000000000000000000000000000000000000000000000000000000000000000000000001
10000000000000000000000000000000000000000000000000000000000000000000000000000000000000000000000000000000000000000000000000001
10000000000000000000000000000000000000000000000000000000000000000000000000000000000000000000000000000000000000000000000000001
10000000000000000000000000000000000000000000000000000000000000000000000000000000000000000000000000000000000000000000000000001
10000000000000000000000000000000000000000000000000000000000000000000000000000000000000000000000000000000000000000000000000001
10000000000000000000000000000000000000000000000000000000000000000000000000000000000000000000000000000000000000000000000000001
10000000000000000000000000000000000000000000000000000000000000000000000000000000000000000000000000000000000000000000000000001
10000000000000000000000000000000000000000000000000000000000000000000000000000000000000000000000000000000000000000000000000001
10000000000000000000000000000000000000000000000000000000000000000000000000000000000000000100000000000000000000000000000000001
10000000000000000000000000000000000000000000000000000100000000000000001000100000000000000100000000000000000000000000000000001
10000000000000000000000000000000000000000011000000000100000000000001110000111000000000001110000000000000000000000000000000001
10000000000000000000000000000000000000000011000000000100000000000100000000011000000000000110000000000000000000000000000000001
10000000000000000000000000000000000000000010000000000100000001011000000000011000000000000010000000000000000000000000000000001
10000000000000000000000000000000000000000010000000000100010111101100000000010000000000000111100000000000000000000000000000001
10000000000000000000000000000000000000000011000000000100100000000101000000011000000000000101100000000000000000000000000000001
10000000000000000000000000000000000000000010000000000100100000000001110000010000000000111111000000000000000000000000000000001
10000000000000000000000000000000000011100110000000000100100000000000100000001000000000011110111000000000000000000000000000001
10000000000000000000000000000000000000000011111111111100110000000000110000011000000000001001110010001101000000110000000000001
10000000000000000000000000000000000000000010010000001100111000000001000000011000000000001100010000000000000011110000000000001
10000000000000000000000000000000000000000000000000000110011010010111100000001111111111001000010000000000000000000000000000001
10000000000000000000000000000000000000000010000000000010011001110000000000001111001000000000010000000000000000000000000000001
10000000000000000000000000000000000000000011000000000010000000000000000000000000000000000000000000000000000000000000000000001
10000000000000000000000000000000000000000010000000000110000000000000000000000000000000000000000000000000000000000000000000001
10000000000000000000000000000000000000000010000000000010000000000000000000000000000000000000000000000000000000000000000000001
10000000000000000000000000000000000000000000000000000010000000000000000000000000000000000000000000000000000000000000000000001
10000000000000000000000000000000000000000000000000000000000000000000000000000000000000000000000000000000000000000000000000001
10000000000000000000000000000000000000000000000000000000000000000000000000000000000000000000000000000000000000000000000000001
10000000000000000000000000000000000000000000000000000000000000000000000000000000000000000000000000000000000000000000000000001
10000000000000000000000000000000000000000000000000000000000000000000000000000000000000000000000000000000000000000000000000001
10000000000000000000000000000000000000000000000000000000000000000000000000000000000000000000000000000000000000000000000000001
10000000000000000000000000000000000000000000000000000000000000000000000000000000000000000000000000000000000000000000000000001
10000000000000000000000000000000000000000000000000000000000000000000000000000000000000000000000000000000000000000000000000001
10000000000000000000000000000000000000000000000000000000000000000000000000000000000000000000000000000000000000000000000000001
10000000000000000000000000000000000000000000000000000000000000000000000000000000000000000000000000000000000000000000000000001
10000000000000000000000000000000000000000000000000000000000000000000000000000000000000000000000000000000000000000000000000001
10000000000000000000000000000000000000000000000000000000000000000000000000000000000000000000000000000000000000000000000000001
10000000000000000000000000000000000000000000000000000000000000000000000000000000000000000000000000000000000000000000000000001
10000000000000000000000000000000000000000000000000000000000000000000000000000000000000000000000000000000000000000000000000001
10000000000000000000000000000000000000000000000000000000000000000000000000000000000000000000000000000000000000000000000000001
10000000000000000000000000000000000000000000000000000000000000000000000000000000000000000000000000000000000000000000000000001
10000000000000000000000000010000000000000000000000000000000000000000000000000000000000000000000000000000000000000000000000001
10000000000000000000000000110000000000000000000000000000000000000000000000000000000000000000000000000000000000000000000000001
10000000000000000000000010000000000000000000000000000000000000000011000000000000000000000000000000000000000000000000000000001
10000000000000000000001000000111011000000000000000001111000001000001000000000000000000000000000000000000000000000000000000001
10000000000000001010100010000000000111000000000000001000000000000001000000000000000000000000000000000000000000000000000000001
10000000000000000100110000000000100111000000000000001000000000000001000000000000000000000000000000000000000000000000000000001
10000000000000010001100000000000011110100000000000000000000000000001000000000000000000000000000000000000000000000000000000001
10000000000110001100000100000000000100100000000000000000000000000001000000000000000000000000000000000000000000000000000000001
10000000100000010101100000000000000000000000000000001001100001110000000000000000000000000000000000000000000000000000000000001
10000001010100011110000000000000000000100000000000001110000000000000000000000000000000000000000000000000000000000000000000001
10000000000100000010000000000000100000100000000000000000000000000000000000000000000000000000000000000000000000000000000000001
10000000000010000100000011000001110000100000000000000000000000000001000000000000000000000000000000000000000000000000000000001
10000000001100010000111110000000010000000000000000000000000000000000000000000000000000000000000000000000000000000000000000001
10000000001001101000100101000000000000100000000000000000000000000000000000000000000000000000000000000000000000000000000000001
10000000000011010000000011000011100000010000000000000000000000000000000000000000000000000000000000000000000000000000000000001
10000000000100001000000011000000000000010100000000000000000000000000000000000000000000000000000000000000000000000000000000001
10000000000110000000000001100010000000000110000000000000000000000000010000000000000000000000000000000000000000000000000000001
10000010000001000000000000011000000000000010000000000000000000000000000000000000000000000000000000000000000000000000000000001
10000100000000100000000000000000000000000000000000000000000000000000000000000000000000000000000000000000000000000000000000001
10001000000000100000001000000000000000110000000000000000000000000000000000000000000000000000000000000000000000000000000000001
10010000000000011000110000000000100001000000000000000000000000000000001000000000000000000000000000000000000000000000000000001
10110000000000001000000010000000000100000000000000000000000000000000001100000000000000000000000000000000000000000000000000001
10100000000000000001011100000000001000000000000000000000000000000000000000000000000000000000000000000000000000000000000000001
11000000000000000000000000000000000000000000000000000000000000000000000000000000000000000000000000000000000000000000000000001
11111111111111111111111111111111111111111111111111111111111111111111111111111111111111111111111111111111111111111111111111111
