1111111111
1000000001
1000000001
1000000001
10000E0001
1000000001
10P0000001
1000000C01
10P0000001
1111111111
