1111111111
1000000001
1000E00001
1000000001
100E000001
1000000001
1000CP0001
1000000001
1000000001
1111111111
