111111111111
100000000001
10CC00C00001
10000P000000
100000000001
100E00000001
100000000001
111111111111
