111111111111
100000000001
1000CCCC0001
100000000001
100000000E01
100000000001
100000000001
111111111111
