111111111
100000001
10E0C0001
100000001
10000P00
100000001
100000001
111111111
